Alabama	,Montgomery
Alaska,Juneau
Arizona	,Phoenix
Arkansas,	Little rock
California,	Sacramento
Colorado,	Denver
Connecticut	,	Hartford
Delaware	,	Dover
Florida	,	Tallahassee
Georgia	,	Atlanta
Hawaii,Honolulu
Idaho	,Boise
Illinois	,	Springfield
Indiana	,	Indianapolis
Iowa	,Des Moines
Kansas	,	Topeka
Kentucky	,	Frankfort
Louisiana	,	Baton Rouge
Maine	,Augusta
Maryland,	Annapolis
Massachusetts	,	Boston
Michigan	,	Lansing
Minnesota	,	St. Paul
Mississippi,	Jackson
Missouri	,Jefferson City
Montana	,	Helena
Nebraska	,	Lincoln
Nevada	, City
New hampshire	,	Concord
New jersey,	Trenton
New mexico,	Santa Fe
New York	,	Albany
North Carolina,	Raleigh
North Dakota	,	Bismarck
Ohio	,	Columbus
Oklahoma	,	Oklahoma City
Oregon	,	Salem
Pennsylvania	,	Harrisburg
Rhode island	,	Providence
South carolina	,	Columbia
South dakota,	Pierre
Tennessee,Nashville
Texas	,	Austin
Utah	,	Salt Lake City
Vermont	,	Montpelier
Virginia	,	Richmond
Washington	,	Olympia
West Virginia	,	Charleston
Wisconsin	,	Madison
Wyoming	,	Cheyenne